NO textures/bluestone.xpm
SO textures/brick.xpm
WE textures/wall_2.xpm
EA textures/wall_1.xpm


C 57,57,57
F 109,109,109


        1111111111111111111111111
        1000000000110000000000001
        101100000111000000S000001
        1001000000000000000000001
111111111011000001110000000000001
100000000011000001110111111111111
11110111111111010000000010001
11110111110111011101010010001
11000000110101011100000010001
10000000000000001100000010001
10000000000000001101010000001
1100000111010101111101111000111
11110111 1110101 101111010001
11111111 1111111 11111111111111